                spot_name                |              domain              | domain_count
-----------------------------------------+----------------------------------+--------------
 Vivat Bacchus                           | vivatbacchus.co.uk               |            2
 Lobos                                   | lobostapas.co.uk                 |            2
 The Botanist                            | thebotanist.uk.com               |            3
 The Cornish Bakery                      | thecornishbakery.com             |            2
 Nobu                                    | noburestaurants.com              |            7
 The Five Fields                         | fivefieldsrestaurant.com         |            2
 Pizza Union                             | pizzaunion.com                   |            3
 The Espresso Room                       | theespressoroom.london           |            2
 Spris Pizza                             | sprispizza.com                   |            2
 Prezzo                                  | prezzorestaurants.co.uk          |            3
 Banana                                  | bananacph.com                    |            3
 Coffee Collective                       | coffeecollective.dk              |            2
 Blondies Kitchen                        | blondieskitchen.co.uk            |            3
 Toby Carvery                            | tobycarvery.co.uk                |            2
 Okan                                    | okanlondon.com                   |            2
 Atariya Foods                           | atariya.co.uk                    |            2
 Omnino                                  | omninorestaurants.com            |            2
 Hotel du Vin                            | hotelduvin.com                   |            2
 In-N-Out Burger                         | in-n-out.com                     |            2
 Sticks'n'Sushi                          | sticksnsushi.com                 |           18
 Black Tap                               | blacktapme.com                   |            2
 La Petite Maison                        | lpmrestaurants.com               |            2
 Casa do Frango                          | casadofrango.co.uk               |            2
 Bancone                                 | bancone.co.uk                    |            2
 Wing It                                 | wingit.ie                        |            2
 Ferdi                                   | ferdi-restaurant.com             |            2
 Bubbleology                             | bubbleologyusa.com               |            2
 Osteria 16                              | osteria16.dk                     |            2
 Red's True Barbecue                     | truebarbecue.com                 |            2
 Buenos Aires                            | barestaurant.com                 |            2
 Browns                                  | browns-restaurants.co.uk         |            2
 Flax & Kale                             | flaxandkale.com                  |            2
 London Cocktail Club                    | londoncocktailclub.co.uk         |            2
 Dishoom                                 | dishoom.com                      |            8
 The Pig                                 | thepighotel.com                  |            3
 Piccolino                               | piccolinorestaurants.com         |            5
 Eggslut                                 | eggslut.com                      |            8
 All Star Lanes                          | allstarlanes.co.uk               |            5
 Tommi's Burger Joint                    | tommis.is                        |            2
 Dirty Bones                             | dirty-bones.com                  |            5
 Tapas Revolution                        | tapasrevolution.com              |            4
 Banana Tree                             | bananatree.co.uk                 |            2
 Miller & Carter                         | millerandcarter.co.uk            |           11
 Fortnum & Mason                         | fortnumandmason.com              |            2
 Bosco Pizzeria                          | boscopizzeria.co.uk              |            2
 Dabbawal                                | dabbawal.com                     |            2
 Bulla Gastrobar                         | bullagastrobar.com               |            7
 Shoryu Ramen                            | shoryuramen.com                  |            2
 Mildreds                                | mildreds.co.uk                   |            4
 Los Mochis                              | losmochis.co.uk                  |            2
 Kayal                                   | kayalrestaurant.com              |            2
 Banter NYC                              | banternyc.com                    |            2
 Suvlaki                                 | suvlaki.co.uk                    |            2
 Duke's Grocery                          | dukesgrocery.com                 |            2
 EL&N London                             | elnlondon.co.uk                  |            2
 Ognisko Restaurant                      | ogniskorestaurant.co.uk          |            2
 Prawn on the Lawn                       | prawnonthelawn.com               |            2
 Bunga Bunga                             | bungabunga.com                   |            2
 Honest Burgers                          | honestburgers.co.uk              |            6
 The Athenian                            | theathenian.co.uk                |            3
 Tamarind                                | tamarindrestaurant.com           |            2
 Fieldwork Brewing Company               | fieldworkbrewing.com             |            2
 Temper                                  | temperrestaurant.com             |            3
 Natural History Museum                  | nhm.ac.uk                        |            2
 Martin's BBQ                            | martinsbbqpr.net                 |            2
 Nando's                                 | nandos.co.uk                     |            7
 Beam                                    | cafebeam.co.uk                   |            2
 Boston Tea Party                        | bostonteaparty.co.uk             |            4
 Lussmanns                               | lussmanns.com                    |            4
 Emilia's Crafted Pasta                  | emiliaspasta.com                 |            2
 Voodoo Ray's                            | voodoorays.com                   |            4
 Nando's                                 | nandos.ie                        |            3
 Four Seasons                            | fs-restaurants.co.uk             |            3
 Pizza Express                           | pizzaexpress.com                 |            7
 Gaucho                                  | gauchorestaurants.com            |            5
 La Campagna                             | la-campagna.co.uk                |            3
 Musafir                                 | musafir.com.ua                   |            3
 Chicama                                 | chicamalondon.com                |            2
 Shangri-La                              | shangri-la.com                   |            4
 Ego                                     | egorestaurants.co.uk             |            2
 Thai Square                             | thaisq.com                       |            3
 Zaap Thai Street Food                   | zaapthai.co.uk                   |            2
 Hubbox                                  | hubbox.co.uk                     |            2
 Bocas Grill                             | bocasgrill.com                   |            3
 Market Halls                            | markethalls.co.uk                |            3
 Absurd Bird                             | absurdbird.com                   |            2
 Piadera                                 | piadera.com                      |            2
 Bestia                                  | bestiala.com                     |            2
 TGI Fridays                             | tgifridays.co.uk                 |            3
 L'Antica Pizzeria                       | anticapizzeria.co.uk             |            2
 tashas                                  | tashascafe.com                   |            2
 Pophams                                 | pophamsbakery.com                |            2
 Beany Green                             | daisygreenfood.com               |            2
 Made of Dough                           | madeofdough.co.uk                |            2
 Daylesford Organic                      | daylesford.com                   |            4
 The Gate                                | thegaterestaurants.com           |            4
 Harry's Dolce Vita                      | harrysdolcevita.com              |            2
 Rye Bakery                              | rye-bakery.com                   |            2
 Pizza Pilgrims                          | pizzapilgrims.co.uk              |           10
 Padella                                 | padella.co                       |            2
 Bleecker                                | bleeckerburger.co.uk             |            3
 Noble Rot                               | noblerot.co.uk                   |            2
 Kricket                                 | kricket.co.uk                    |            3
 Blacklock                               | theblacklock.com                 |            3
 Barrafina                               | barrafina.co.uk                  |            4
 Caf√© Rouge                              | caferouge.co.uk                  |            2
 Wild & The Moon                         | wildandthemoon.ae                |            3
 Goodman                                 | goodmanrestaurants.com           |            2
 Bread Street Kitchen                    | gordonramsayrestaurants.com      |            2
 Hoppers                                 | hopperslondon.com                |            3
 Sticks‚Äôn‚ÄôSushi - Victoria               | sticksnsushi.com                 |            2
 Time Out Market                         | timeoutmarket.com                |            2
 Amorino                                 | amorino.com                      |            5
 STK                                     | stksteakhouse.com                |            3
 Brat                                    | bratrestaurant.com               |            2
 Fire Wings                              | firewings.com                    |            8
 Caravan                                 | caravanrestaurants.co.uk         |            5
 Olive + Squash                          | oliveandsquash.co.uk             |            2
 Revoluci√≥n de Cuba                      | revoluciondecuba.com             |            2
 Xi'an Famous Foods                      | xianfoods.com                    |            4
 Pubbelly Sushi                          | pubbellyglobal.com               |            6
 Pho                                     | phocafe.co.uk                    |            5
 All Bar One                             | allbarone.co.uk                  |            2
 Bubbleology                             | bubbleology.co.uk                |            2
 Koya                                    | koya.co.uk                       |            2
 The Chipping Forecast                   | chippingforecast.com             |            2
 Kanishka                                | kanishkarestaurant.co.uk         |            2
 Balans                                  | balans.co.uk                     |            3
 Tantrum Doughnuts                       | tantrumdoughnuts.com             |            2
 Rudy's                                  | rudyspizza.co.uk                 |            2
 Island Pok√©                             | islandpoke.com                   |            2
 Flesh & Buns                            | fleshandbuns.com                 |            2
 Busaba Eathai                           | busaba.com                       |           11
 Kiyoto Sushi                            | kiyotosushi.co.uk                |            2
 WFM Coffee Bar                          | wholefoodsmarket.com             |            5
 Black Tap Craft Burgers & Shakes        | blacktap.com                     |            2
 Burger & Lobster                        | burgerandlobster.com             |           19
 Wetherspoons                            | jdwetherspoon.com                |            3
 Oka                                     | okarestaurant.co.uk              |            3
 The Mac Factory                         | themacfactory.co.uk              |            2
 Bread Ahead                             | breadahead.com                   |            4
 Greggs                                  | greggs.co.uk                     |            4
 The Coconut Tree                        | thecoconut-tree.com              |            3
 Lina Stores                             | linastores.co.uk                 |            3
 Wingstop                                | wingstop.co.uk                   |            2
 Per Tutti                               | pertuttirestaurant.co.uk         |            2
 Bocconcino                              | bocconcinorestaurant.co.uk       |            2
 Amazonico                               | amazonicorestaurant.com          |            2
 Wright Brothers                         | thewrightbrothers.co.uk          |            3
 7Bone Burger Co.                        | 7bone.co.uk                      |            2
 Estiatorio Milos                        | estiatoriomilos.com              |            2
 M Burger                                | mburgerchicago.com               |            2
 The Hampstead Butcher & Providore       | hampsteadbutcher.com             |            2
 L'antica Pizzeria da Michele            | anticapizzeriadamichele.co.uk    |            2
 Bone Daddies                            | bonedaddies.com                  |            3
 Santa Nata                              | santanata.com                    |            2
 Subway                                  | subway.co.uk                     |            2
 Lou Malnati's Pizzeria                  | loumalnatis.com                  |            2
 Chick 'n' Sours                         | chicknsours.co.uk                |            3
 Tortilla                                | tortilla.co.uk                   |            2
 Giggling Squid                          | gigglingsquid.com                |           15
 Burger King                             | burgerking.co.uk                 |            2
 Hawksmoor                               | thehawksmoor.com                 |            7
 Rosa's Thai Cafe                        | rosasthaicafe.com                |           12
 Buvette                                 | ilovebuvette.com                 |            2
 Melisi                                  | melisi.co.uk                     |            2
 EL&N                                    | elnlondon.co.uk                  |            6
 Cosy Club                               | cosyclub.co.uk                   |            6
 Moomaid Of Zennor                       | moomaidofzennor.com              |            2
 Eat Tokyo                               | eattokyo.co.uk                   |            3
 Farm Girl                               | thefarmgirl.co.uk                |            2
 Vinoteca                                | vinoteca.co.uk                   |            2
 Wimpy                                   | locations.wimpy.uk.com           |            4
 Soft Serve Society                      | softservesociety.com             |            2
 Bar Azita                               | barazita.co.uk                   |            2
 Habaneros                               | habaneros.co.uk                  |            2
 Marchesi 1824                           | pasticceriamarchesi.com          |            2
 Fora                                    | forarestaurants.co.uk            |            2
 Panino Giusto                           | paninogiusto.it                  |            2
 Roka                                    | rokarestaurant.com               |            4
 Common Grounds                          | commongroundsdubai.com           |            2
 Sugar Factory                           | sugarfactory.com                 |            2
 Gail's                                  | gailsbread.co.uk                 |            2
 Hach√© Burgers                           | hacheburgers.com                 |            2
 McDonalds                               | mcdonalds.com                    |            2
 DF Tacos                                | dftacos.co.uk                    |            2
 Saint Espresso                          | saintespresso.com                |            2
 The Leopard Inn                         | theleopardinn.co.uk              |            2
 Coffee & Thyme                          | coffeeandthyme.co                |            2
 The Collab                              | thecollablondon.com              |            2
 George's Great British Kitchen          | georgesgreatbritishkitchen.co.uk |            2
 Half Cup                                | halfcup.co.uk                    |            2
 Friends Avenue Cafe                     | friendsavenue.ae                 |            2
 Brunch & Cake                           | brunchandcake.com                |            2
 Petersham Nurseries                     | petershamnurseries.com           |            2
 Ole & Steen                             | oleandsteen.co.uk                |            3
 by CHLOE.                               | eatbychloe.com                   |           17
 S√∂derberg                               | soderberg.uk                     |            2
 Cartems Donuts                          | cartems.com                      |            2
 Mowgli Street Food                      | mowglistreetfood.com             |            8
 Cowshed                                 | cowshed.com                      |            4
 The Lunch Box                           | thelunchbox.co.uk                |            3
 Ippudo                                  | ippudony.com                     |            3
 Fat Hippo                               | fathippo.co.uk                   |            3
 Almost Famous                           | almostfamousburgers.com          |            2
 Las Iguanas                             | iguanas.co.uk                    |            2
 The Breakfast Club                      | thebreakfastclubcafes.com        |            5
 Oath Pizza                              | oathpizza.com                    |            6
 Bill's                                  | bills-website.co.uk              |            8
 Zuma                                    | zumarestaurant.com               |           14
 Brasserie Z√©del                         | brasseriezedel.com               |            2
 Chez Antoinette                         | chezantoinette.co.uk             |            2
 Black Tap                               | blacktap.ch                      |            2
 Dirty Burger                            | eatdirtyburger.com               |            2
 Buddha Bar                              | buddhabarlondon.com              |            2
 Hard Rock Cafe                          | hardrockcafe.com                 |            2
 Chaophraya                              | chaophraya.co.uk                 |            7
 Cake Box                                | eggfreecake.co.uk                |            3
 Wingmans                                | wingmans.co.uk                   |            2
 Coppa Club                              | coppaclub.co.uk                  |            4
 Boom Bap Burger                         | boombapburger.com                |            2
 Fazenda                                 | fazenda.co.uk                    |            3
 Indian Accent                           | indianaccent.com                 |            3
 SUSHISAMBA                              | sushisamba.com                   |            4
 Le Relais de Venise l'Entrec√¥te         | relaisdevenise.com               |            2
 Bun House                               | bun.house                        |            2
 Foot Locker                             | stores.footlocker.dk             |            2
 BaoziInn                                | baoziinn.com                     |            3
 Poppies Fish & Chips                    | poppiesfishandchips.co.uk        |            2
 Allegra                                 | allegra-restaurant.com           |            2
 Giordano's                              | giordanos.com                    |            2
 Ippudo                                  | ippudo.co.uk                     |            4
 Rick Stein                              | rickstein.com                    |            2
 Taco Mamacita                           | tacomamacita.com                 |            2
 Manekineko                              | manekineko.com.br                |            5
 Five Guys                               | restaurants.fiveguys.co.uk       |            9
 The Spread Eagle                        | thespreadeaglelondon.co.uk       |            2
 Heartcore                               | heartcore.co.uk                  |            7
 Peggy Porschen                          | peggyporschen.com                |            2
 GAIL's                                  | gailsbread.co.uk                 |            5
 Wagamama                                | wagamama.com                     |            3
 Theo's                                  | theospizzeria.com                |            2
 Pancake Pantry                          | pancakepantry.com                |            2
 Cactus Jack's                           | cactusjacks.com.au               |            3
 Artist Residence                        | artistresidence.co.uk            |            2
 The Salty Donut                         | saltydonut.com                   |            3
 Pastaio                                 | pastaio.co.uk                    |            2
 Everyman                                | everymancinema.com               |            2
 Six by Nico                             | sixbynico.co.uk                  |            3
 Hotbox                                  | hotboxlondon.co.uk               |            2
 Zaza                                    | zaza.co.uk                       |            4
 O'Neill's                               | oneills.co.uk                    |            2
 Grabli                                  | grabli.ru                        |            2
 Kushi                                   | kushirestaurant.co.uk            |            2
 Gourmet Burger Kitchen                  | gbk.co.uk                        |            2
 Radio Alice Pizzeria                    | radioalicepizzeria.co.uk         |            3
 Hach√© Burgers Chelsea                   | hacheburgers.com                 |            2
 Milsoms                                 | milsomhotels.com                 |            2
 Topgolf                                 | topgolf.com                      |            2
 Nammos                                  | nammos.gr                        |            2
 Leon                                    | leon.co                          |            2
 C√¥te                                    | cote.co.uk                       |            2
 Slim Chickens                           | slimchickens.co.uk               |            2
 Sticks'n' Sushi Soho                    | sticksnsushi.com                 |            2
 Santa Maria                             | santamariapizzeria.com           |            3
 C√¥te Brasserie                          | cote.co.uk                       |            3
 Big Easy Bar.B.Q & Crabshack            | bigeasy.co.uk                    |            3
 Caff√® Concerto                          | caffeconcerto.co.uk              |            3
 KFC                                     | kfc.co.uk                        |            3
 Tonkotsu                                | tonkotsu.co.uk                   |           10
 Yard Sale Pizza                         | yardsalepizza.com                |            5
 Pizza East                              | pizzaeast.com                    |            2
 The Ampersand Hotel                     | ampersandhotel.com               |            2
 Mandarin Oriental                       | mandarinoriental.com             |            3
 My Old Dutch                            | myolddutch.com                   |            2
 YO! Sushi                               | yosushi.com                      |            3
 Miscusi                                 | miscusi.com                      |            2
 Lantana                                 | lantanacafe.co.uk                |            2
 Sumosan Twiga                           | sumosantwiga.com                 |            2
 Carluccio's                             | carluccios.com                   |            2
 Itsu                                    | itsu.com                         |            4
 Origin Coffee Roasters                  | origincoffee.co.uk               |            2
 Kaffeine                                | kaffeine.co.uk                   |            2
 Zelman Meats                            | zelmanmeats.com                  |            2
 Le Pain Quotidien                       | lepainquotidien.com              |            6
 CVI.CHE 105                             | ceviche105.com                   |            3
 Harrods                                 | harrods.com                      |            2
 Maze Grill                              | gordonramsayrestaurants.com      |            2
 Ella Canta                              | ellacanta.com                    |            2
 French Connection                       | frenchconnection.com             |            6
 PizzaExpress                            | pizzaexpress.com                 |            3
 Chucs                                   | chucsrestaurants.com             |            2
 220GRAD                                 | 220grad.com                      |            2
 Purezza                                 | purezza.co.uk                    |            2
 Ayllu                                   | ayllu.co.uk                      |            2
 Carousel                                | carousel-london.com              |            2
 Pieminister                             | pieminister.co.uk                |            3
 Homeslice                               | homeslicepizza.co.uk             |            6
 Gin & Juice                             | ginandjuice.com                  |            2
 Sticks'n'Sushi Covent Garden            | sticksnsushi.com                 |            2
 Street Pizza Gordon Ramsay              | gordonramsayrestaurants.com      |            2
 Cambridge Wine Merchants                | cambridgewine.com                |            2
 Frankies Pizza                          | frankiespizza.dk                 |            7
 Hakkasan                                | hakkasan.com                     |           11
 Mikkeller                               | mikkeller.dk                     |            2
 Mr Miyagi's                             | mr-miyagis.com                   |            2
 Kibou                                   | kibou.co.uk                      |            2
 Copenhagen Coffee Lab                   | copenhagencoffeelab.com          |            3
 Sticks'n'Sushi Canary Wharf             | sticksnsushi.com                 |            2
 Rabieng                                 | rabiengthai.com                  |            2
 Heartbreak Hotel Coffee                 | heartbreakhotelcoffee.com        |            2
 Starbucks                               | starbucks.com                    |            2
 Gasoline Grill                          | gasolinegrill.com                |            4
 Flat Iron                               | flatironsteak.co.uk              |            9
 Junkyard Golf Club                      | junkyardgolfclub.co.uk           |            3
 Vagabond                                | vagabondwines.co.uk              |            2
 Comptoir Libanais                       | comptoirlibanais.com             |           22
 Burgers and Brew                        | burgersnbrew.com                 |            2
 Pix Pintxos                             | pix-bar.com                      |            3
 Taro                                    | tarorestaurants.uk               |            2
 Koi                                     | koirestaurant.com                |            2
 Beso Beach                              | besobeach.com                    |            2
 Yauatcha                                | yauatcha.com                     |            2
 Carissa's the Bakery                    | carissasthebakery.com            |            2
 Comptoir Gourmand                       | comptoirgourmand.co.uk           |            2
 Ottolenghi                              | ottolenghi.co.uk                 |            4
 Tattu                                   | tattu.co.uk                      |            3
 Mercato Metropolitano                   | mercatometropolitano.com         |            2
 The Alchemist                           | thealchemist.uk.com              |            4
 Melange                                 | melangerestaurant.co.uk          |            2
 Butchies                                | butchies.co.uk                   |            2
 Hard Rock Cafe - Park Lane              | hardrockcafe.com                 |            2
 The Blues Kitchen                       | theblueskitchen.com              |            3
 Draughts                                | draughtslondon.com               |            2
 Fatto a Mano                            | fattoamanopizza.com              |            2
 Franco Manca                            | francomanca.co.uk                |           13
 Monte Mar                               | montemar.pt                      |            3
 Mediterranevm                           | mediterranevm.co.uk              |            2
 Coya                                    | coyarestaurant.com               |            2
 Gusto                                   | gustorestaurants.uk.com          |           11
 Costa Coffee                            | costa.co.uk                      |            3
 Be At One                               | beatone.co.uk                    |            2
 MEAT Liquor                             | meatliquor.com                   |            9
 Bagel Factory                           | bagelfactory.co.uk               |            2
 The Hoxton                              | thehoxton.com                    |            8
 Harris + Hoole                          | harrisandhoole.co.uk             |            3
 Wildwood                                | wildwoodrestaurants.co.uk        |            3
 Four Seasons                            | fourseasons.com                  |            3
 Doughnut Time                           | doughnuttime.co.uk               |            2
 Eat a Pitta                             | eatapitta.co.uk                  |            4
 Department of Coffee and Social Affairs | departmentofcoffee.com           |            2
 The Real Greek                          | therealgreek.com                 |            5
 YO! Sushi                               | yosushi.me                       |            2
 Mobile Phone Repair Doctor              | mobilephonerepairdoctor.co.uk    |            2
 T-Mobile                                | t-mobile.pl                      |            2
 Pollo Tropical                          | pollotropical.com                |            7
 Taqueria                                | taqueria.co.uk                   |            2
 Farmer J                                | farmerj.com                      |            2
 Joe's Pizza                             | joespizzanyc.com                 |            5
 Taverna del Marinaio                    | tavernadelmarinaio.com           |            2
 Mexican Sugar                           | mexicansugarcocina.com           |            2
 Cabana                                  | cabana-brasil.com                |            2
 Sofra                                   | restoransofra.com                |            2
 Tapas Brindisa                          | brindisakitchens.com             |            3
 Heavenly Desserts                       | heavenlydesserts.co.uk           |            3
 San Carlo                               | sancarlo.co.uk                   |            2
 KERB                                    | kerbfood.com                     |            3
 BrewDog                                 | brewdog.com                      |            2
 German Doner Kebab                      | germandonerkebab.com             |            3
 Forty Hands                             | 40handscoffee.com                |            2
 wagamama                                | wagamama.com                     |            4
 Patty & Bun                             | pattyandbun.co.uk                |            9
 B Bagel Bakery Bar                      | bbagel.co.uk                     |            2
 Buddha Bar                              | buddhabar.com                    |            3
 Hopper & Bean                           | hopperandbean.com                |            2
 C London                                | crestaurant.co.uk                |            2
 Turtle Bay                              | turtlebay.co.uk                  |            4
 Burger & Beyond                         | burgerandbeyond.co.uk            |            2
 The Rib Room                            | jumeirah.com                     |            2
 Cafe Murano                             | cafemurano.co.uk                 |            3
 Wild Bean Cafe                          | bp.com                           |            2
 Fego                                    | hellofego.com                    |            3
 B√°nh B√°nh                               | banhbanh.com                     |            2
(383 rows)

